7 7
#######
#@@   #
#  O  #
#  O  #
#  O  #
#  O  #
#######